%
M48
M72
T01C0.0200
T02C0.0354
T03C0.0400
T04C0.1300
%
T01
X14333Y9333
X11833Y9583
X11333Y12483
X12333Y12483
X11833Y13783
X12933Y13783
X15993Y13533
X16333Y12883
X16833Y12583
X19833Y13333
X20333Y13333
X20833Y13333
X21333Y13333
X23333Y14833
X21333Y16333
X20833Y16333
X20833Y16833
X19833Y16333
X18833Y15333
X18333Y15333
X17833Y15333
X16833Y15183
X17333Y14333
X18833Y14333
X18833Y14833
X15983Y16333
X14333Y16083
X12833Y16083
X11833Y16833
X14583Y17833
X16333Y18333
X17833Y17833
X17833Y17333
X19333Y18333
X22333Y11083
T02
X20333Y10583
X19333Y10583
X18333Y10583
X17333Y10583
X16333Y10583
X15333Y10583
X15333Y19083
X16333Y19083
X17333Y19083
X18333Y19083
X19333Y19083
X20333Y19083
T03
X13333Y7833
X14333Y7833
X15333Y7833
X16333Y7833
X17333Y7833
X18333Y7833
X19333Y7833
X20333Y7833
X21333Y7833
X22333Y7833
X15333Y16333
X15333Y21833
X16333Y21833
X17333Y21833
X18333Y21833
X19333Y21833
X20333Y21833
T04
X23833Y21333
X11833Y21333
X11833Y8333
X23833Y8333
M30
